**********
|        |
|    +   |
|    +   |
|    +   |
|  Markus|
**********