**********
|        |
|    +   |
|    +   |
|    +   |
|        |
**********